*S*****
*.*****
*...***
***.***
***.***
***..**
****.**
****.**
****.**
****.**
****..*
*****.*
*****.*
*****.*
.....E.